---F----
---*----
---**---
----***-
------*-
------S-